SO                                             ./asset/Water_1.xpm
WE                                        ./asset/Water_6.xpm
EA ./asset/Water_11.xpm
NO ./asset/Water_10.xpm
C +134,0000000159,247
F 24,100,171


1111111
111D111
1100011
1D0N0D1
1100011
111D111
1111111
