SO                                             ./asset/Water_1.xpm
WE                                        ./asset/Water_6.xpm
EA ./asset/Water_11.xpm
NO ./asset/Water_10.xpm
C +134,0000000159,247
F 24,100,171


11111111
11NS1
11111