SO                                             ./asset/Water_1.xpm
WE                                        ./asset/Water_11.xpm
EA ./asset/Water_10.xpm
NO 			./asset/Water_12.xpm
C +134,0000000159,247       
F 24,100,171

11111111111111111111111111111111111111111111111111111111111111111
10000000000000000000000000000001111111111111000000000011111111111
10000000000001000000000000000001100011111100011111001111111111111
10000000000000000000000000000001101000000000100000000000000000111
10000000000000000000000000001110001111111111111111111111111111111
100000100000000000000000000010011011111
100000000000000000000000000001011011111
111111110000000000000000000001011000111
100E00011111111000000000000001011110111
10111011000000111111111111100101111011111111111111111111111111111
10011011111100100000000000000101111011111111101111111111110001111
10011010100000001111111111111100000001111100000000011111110111111
10011000001111100000000000000001111100000001111011000000000111111
11111111111111111111111111111111111111111111111111111111111111111
