SO                                             ./asset/wall_brick.xpm
WE                                        ./asset/wall_dragon.xpm
EA ./asset/wall_rock.xpm
NO ./asset/wall_wood.xpm
C +225,000000030,+1
F 220,100,14

11111111111111111111111111111111
10000000000000000000000000000001
10000000000001000000000000000001
10000000000000000000000000000001
10000000000000000000000000001111
10000010000000000000000000001001
10000000000000000000000000000101
11111111000000000000000000000101
10000001111111100000000000000101
10111011000000111111111111100101
10011011111100100000000000000101
10011010100000001111111111111101
10N11000001111100000000000000001
11111111111111111111111111111111
