SO                                             ./asset/Water_1.xpm
WE                                        ./asset/Water_11.xpm
EA ./asset/Water_10.xpm
NO 			./asset/Water_12.xpm
C +134,0000000159,247       
F 24,100,171

11111111111111111111111111111111
10000000000000000000000000000001
10000000000001000000000000000001
10000000000000000000000000000001
10000000000000000000000000001111
10000010000000000000000000001001
10000000000000000000000000000101
11111111000000000000000000000101
100E0001111111100000000000000101
10111011000000111111111111100101
10011011111100100000000000000101
10011010100000001111111111111101
10011000001111100000000000000001
11111111111111111111111111111111
