SO                                             ./asset/Water_1.xpm
WE                                        ./asset/Water_11.xpm
EA ./asset/Water_10.xpm
NO 			./asset/Water_12.xpm

C +134,0000000159,247       

F 24,100,171

111111111111111111111111111111111111111111111111111111111111111111111111111111111111111111111111111111111111111111111111111111111111111111111111111111111111111111111111111111111111111111111111111111111111111111111111111111111111111111111111111111111111111111111111111111111111111111111111111111111111111111111111111111111111111111111111111111111111111111111111111111111111111111111111111111111111111111111111111111111111111111111                      11111111                     1111111                      11111111                     111111                       11111111            11111111111111111111111111111111111111111111111111111111111111111111111111111111111111111111111111111111111111111111111111111111111111111111111111111111111111111111111111111111111111111111111111111111111111111111111111111111111111111111111111111111111111111111111111111111111111111111111111111111111111111111111111111111111111111111111111111111111111111111111111111111111            11111111                     1111111                      11111111                     111111                       11111111                        11111111                     1111111                      11111111                     111111                       11111111                        11111111                     1111111                      11111111                     111111                       11111111            1111111111111111111111111111111111111111111111111111111111111111111111111111111111111111111111111111111111111111111111111111111111111111111111111111111111111111111111111111111111111111111111111111111111111111111111111111111111111111111111111111111111111111111111111111111111111111111111111111111111111111111111111111111111111111111111111111111111111111111111111111111111111111111111111111111111111111111111111111111111111111111111111111111111111111111111111111111111111111111111111111111111111111111111111111111111111111111111111111111111111111111111111111111111111111111111111111111111111111111111111111111111111111111111111111111111111111111111111111111111111111111111111111111
100000000000000000000000000000000000000001B000000000000000100000000100000000100000000100000000100000000100000000100010000000000000000000000000000001000000000000000000000000000000000000100000000000000000000000000000000000000000100000000000000000000000000000000000000000000000000000000000000100000000000000000000001000000000000000000000010000000000000000000000100000000000000000000001000000000000000000000010000000111111111100001111                  111100001111                 11100001111                  111100001111                 11100001111                  111100001111          10000000000000000000000000000000000000001000000000000000000000010000000000000000000000100000000000000000000001000000000000000000000010000000000000000000000100000000000000000011000000000000000000000000001100000000000000000000000000110000000000000000000000000000000000000000000000000000001100000000000000000000000000110000000000000000000000000011000000000000000000000000001          111100001111                 11100001111                  111100001111                 11100001111                  111100001111                    111100001111                 11100001111                  111100001111                 11100001111                  111100001111                    111100001111                 11100001111                  111100001111                 11100001111                  111100001111          1000000000000000000000000000000000000000000000010000000000000000000000100000000000000000000001000000000000000000000010000000000000000000000100000000000000000000001000000000000000000000000000000000010000000000000000000000100000000000000000000001000000000000000000000010000000000000000000000100000000100000000000000000000000000000000010000000000000011000000000000001100000000000000011000000000000000000000000000000000001000000000000000000001000000000000000000000000000000000000000000000000000000000000000000000010000000000000000000000000000000000001000000000000000000000000000000001000000000000000000010000000000000000000100000000000000000001000000000000000000010000000000000000001
1000000000000000000000000000000000000000010000000000000000100000000000110000000000000000001000000000001100000000000001000000000000000000000000000000100000000000000000000000000000000000010000000000000000000000000000000000000000010000000000000000000000000000000000000001000000000001100000000000000000010000000000011000000000000000000000100000000000110000000000000000001000000000001100000000000000000000010000000000011111111000000001111              1111000000001111             111000000001111              1111000000001111             111000000001111              1111000000001111        10000000000000000100000000000110000000000000000001000000000001100000000000000000000010000000000011000000000000000000100000000000110000000000000000000001000000000000000000000011000000000000000000000000001100000000000000000000000000110000000000000000000000000011000000000000000000000000001100000000000000000000000000110000000000000000000000000011000000000000000000000000001        1111000000001111             111000000001111              1111000000001111             111000000001111              1111000000001111                1111000000001111             111000000001111              1111000000001111             111000000001111              1111000000001111                1111000000001111             111000000001111              1111000000001111             111000000001111              1111000000001111        1000000000000000000000001000000000001100000000000000000010000000000011000000000000000000000100000000000110000000000000000001000000000001100000000000000000000010000000000000001000000000001100000000000000000010000000000011000000000000000000000100000000000110000000000000000001000000000001100000000000100000000000000000000000000000000010000000000000011000000000000001100000000000000011000000000000000000000000000000000001000000000000000000001000000000000000000110000000000000000001000000000001100000000000000000010000000000000000000000000000000000001000000000000000000000000000000000000000000010000000000011000000000000000000000100000000000110000000000000000001000000000001100000001
100000000000000000000000000000000000000001000001000000000000010000000000000010010000000000000100000000000000100000000100000000000000100000000000000010000000000000000010000000000000000001000000000000000000100000000000000000000001000000000000000000001000000010000000000000100000000000000100100000000000001000000000000001000001000000000000010000000000000010010000000000000100000000000000100000100000000000001010000001111110000001100001111          11110000111100001111         1110000001100001111          11110000111100001111         1110000001100001111          11110000111100001111      10000010000000000000100000000000000100100000000000001000000000000001000001000000000000010000000000000010010000000000000100000000000000100000100000000000001010000000000000000000000000000000000000000000001100000000000000000000000000110000000000000000000000000011000000000000000000000000000000000000000000000000000000110000000000000000000000000011000000000000000000000000001      11110000111100001111         1110000001100001111          11110000111100001111         1110000001100001111          11110000111100001111            11110000111100001111         1110000001100001111          11110000111100001111         1110000001100001111          11110000111100001111            11110000111100001111         1110000001100001111          11110000111100001111         1110000001100001111          11110000111100001111      10000000000001000000000000010000000000000010010000000000000100000000000000100000100000000000001000000000000001001000000000000010000000000000010000010000000000000101000000000000010000000000000010010000000000000100000000000000100000100000000000001000000000000001001000000000000010000000000000010000001000000000000000010000000000000000100000000000000110000000000000011000000000000000000000000000000000100000000000000000010000000000000010000000000000001000000000000001001000000000000010000000000000010000010000000100000000000000000010000000000000000010000000000000001000000000000010010000000000000100000000000000100000100000000000001000000000000001001000000000000010000000000000010011111111
10000000000000000000000000000000000000000D0I000000000000000000000000000000000000000000000000000000000000000000000000010000000000000010000000000000001000000000000000001000000000000000000100000000000000000010000000000000000000000100000000000000000000100000000000000000100000000000000000000000000000000000000000000100000000000000000000000000000000000000000000000000000000000000000000000000000000000000000000000000000111100000011111100001111      111100001111111100001111     11100000011111100001111      111100001111111100001111     11100000011111100001111      111100001111111100001111    10000000000000001000000000000000000000000000000000000000000001000000000000000000000000000000000000000000000000000000000000000000000000000000000000000000000000000000000000000011000000000000000000000000001100000000000000000000000000000000000000000000000000000011000000000000000000000000001100000000000000000000000000110000000000000000000000000000000000000000000000000000001    111100001111111100001111     11100000011111100001111      111100001111111100001111     11100000011111100001111      111100001111111100001111        111100001111111100001111     11100000011111100001111      111100001111111100001111     11100000011111100001111      111100001111111100001111        111100001111111100001111     11100000011111100001111      111100001111111100001111     11100000011111100001111      111100001111111100001111    100000000000000000000001000000000000000000000000000000000000000000001000000000000000000000000000000000000000000000000000000000000000000000000000000000000000000000000000000001000000000000000000000000000000000000000000001000000000000000000000000000000000000000000000000000000000000000000000000000000010000000000000000100000000000000001000000000000000000000000000000110000000000000001100000000000000001000000000000000000100000000000000100000000000001000000000000000000100000000000000000010000000000000000001000001000000000000000000100000000000000000100000000000000010000000000000000000000001000000000000000000100000000000000000010000000000000000001000000000000000000000000000000000000000G1
10000000000000000000000000000000000000000100000000000000000001000000000000000000000000000000010000000000000000000000010000000000000010000000000000001000000000000000001000000000000000000100000000000000000010000000000000000000000100000000000000000000100000000000000000000010000000000000000000000000000000100000000000000000000000000000000001000000000000000000000000000000010000000000000000000000000000000000100000000111000001111  111100001111  111100001111    111100001111  111000001111  111100001111  111100001111    111100001111  111000001111  111100001111  111100001111    111100001111  10000000000000000000100000000000000000000000000000001000000000000000000000000000000000010000000000000000000000000000000100000000000000000000000000000000001000000000000000000011000000000000000000000000001100000000000000000000000000110000000000000000000000000011000000000000000000000000001100000000000000000000000000110000000000000000000000000011000000000000000000000000001  111100001111    111100001111  111000001111  111100001111  111100001111    111100001111  111000001111  111100001111  111100001111    111100001111    111100001111    111100001111  111000001111  111100001111  111100001111    111100001111  111000001111  111100001111  111100001111    111100001111    111100001111    111100001111  111000001111  111100001111  111100001111    111100001111  111000001111  111100001111  111100001111    111100001111  100000000000000000000000000100000000000000000000000000000001000000000000000000000000000000000010000000000000000000000000000000100000000000000000000000000000000001000000000000000100000000000000000000000000000001000000000000000000000000000000000010000000000000000000000000000000100000000000000000000010000000000000000100000000000000001000000000000001100000000000000110000000000000001100000000000000001000000000000000000100000000000000100000000000000010000000000000000000000000000000100000000000000000000000000001000000000000000000100000000000000000100000000000000010000000000000000000000000000001000000000000000000000000000000000010000000000000000000000000000000100000000000000000000000G1
100000000000000000000000000000000000000001000000000000100000100000000000000010000000001000001000000000000000100000000000000000000000100000000000000000000000000000000010000000000000000000000000000000000000100000000000000000000000000000000000000000001000000000000001000001000000000000000100000000010000010000000000000001000000000000100000100000000000000010000000001000001000000000000000100000000000010000010000000001000001111      1111000011111100001111        1111000011111000001111      1111000011111100001111        1111000011111000001111      1111000011111100001111        11110000111110000000000001000001000000000000000100000000010000010000000000000001000000000000100000100000000000000010000000001000001000000000000000100000000000010000010000000000000000000011000000000000000000000000001100000000000000000000000000110000000000000000000000000011000000000000000000000000001100000000000000000000000000110000000000000000000000000011000000000000000000000000001111100001111        1111000011111000001111      1111000011111100001111        1111000011111000001111      1111000011111100001111        111100001111111100001111        1111000011111000001111      1111000011111100001111        1111000011111000001111      1111000011111100001111        111100001111111100001111        1111000011111000001111      1111000011111100001111        1111000011111000001111      1111000011111100001111        11110000111110000000000000000000100000100000000000000010000000001000001000000000000000100000000000010000010000000000000001000000000100000100000000000000010000000000001000001000000000100000100000000000000010000000001000001000000000000000100000000000010000010000000000000001000000000100000100000000000000010000000000000000000000010000000000000000000000000000000110000000000000011000000000000000110000000000000000100000000000000000000000000000000010000000000000010000000000000001000000000100000100000000000000010000000000000000000000000000000010000000000000000000000000000000001000000000000010000000001000001000000000000000100000000000010000010000000000000001000000000100000100000000000000010011111111
1000W00000000000000000000000000000000000010000001000000000000000000100000000100010000000000000000001000000001000000000000000000000001000000000000000000000000000000000100000000000000000000000000000000000001000000000000000000000000000000000000000000010000000010000000000000000001000000001000100000000000000000010000000010000001000000000000000000100000000100010000000000000000001000000001000000100000000000000010000000001111          111100000000001111            111100000000001111          111100000000001111            111100000000001111          111100000000001111            1111000000000000010000000000000000001000000001000100000000000000000010000000010000001000000000000000000100000000100010000000000000000001000000001000000100000000000000010000000000000000110000000000000000000000000000000000000000000000000000001100000000000000000000000000110000000000000000000000000011000000000000000000000000000000000000000000000000000000110000000000000000000000000000000001111            111100000000001111          111100000000001111            111100000000001111          111100000000001111            11110000000000001111            111100000000001111          111100000000001111            111100000000001111          111100000000001111            11110000000000001111            111100000000001111          111100000000001111            111100000000001111          111100000000001111            11110000000000000000000010000000000000000001000000001000100000000000000000010000000010000001000000000000000000100000000100010000000000000000001000000001000000100000000000000010000000000000000001000000001000100000000000000000010000000010000001000000000000000000100000000100010000000000000000001000000001000000000000000000000001000000000000000000000000000000011000000000000000000000000000000011000000000000000010000000000000000000000000000000001000000000000000000000100000000100010000000000000000001000000001000000100000000000000000000000001000000000000000000000000000000000100000000000001000100000000000000000010000000010000001000000000000000000100000000100010000000000000000001000000001001
10000000000000000000000000000000000000000100000000000010000100000000100000000100000000100000000100000000100000000100000000000000000010000000000000000000000000000000001000000000000000000000000000000000000010000000000000000000000000000000000000000000100000000000000100000000000000000000000000000001000000000000000000000000000000000010000000000000000000000000000000100000000000000000000000000000000001000000000000000000111              11110000001111                11110000000111              11110000001111                11110000000111              11110000001111                111100000000000000000100000000000000000000000000000001000000000000000000000000000000000010000000000000000000000000000000100000000000000000000000000000000001000000000000000000000000001100000000000000000000000000110000000000000000000000000011000000000000000000000000001100000000000000000000000000110000000000000000000000000011000000000000000000000000001100000000000000000000000000000001111                11110000000111              11110000001111                11110000000111              11110000001111                1111000000001111                11110000000111              11110000001111                11110000000111              11110000001111                1111000000001111                11110000000111              11110000001111                11110000000111              11110000001111                111100000000000000000000000010000000000000000000000000000000100000000000000000000000000000000001000000000000000000000000000000010000000000000000000000000000000000100000000000000010000000000000000000000000000000100000000000000000000000000000000001000000000000000000000000000000010000000000000000000000000000000000000000000001000000000000000000000000000000011000000000000001100000000000000011000000000000000010000000000000000000000000000000001000000000000000000000000000000000000000010000000000000000000000000000000000000000000000000000001000000000000000000000000000000000100000000000000000000000100000000000000000000000000000000001000000000000000000000000000000010000000000000000000000001
100000000000000000000000000000000000000001111111111111111111111111111111111111D11111111111111111111111111111111111111111111111111111111111111111111111111111111111111111111111111111111111111111111111111111111111111111111111111111111111111111111111111111111111111111111111111111111111111111111111111111111111111111111111111111111111111111111111111111111111111111111111111111111111111111111111111111111111111111111111111                  1111111111                    1111111111                  1111111111                    1111111111                  1111111111                    11111111111111111111111111111111111111111111111111111111111111111111111111111111111111111111111111111111111111111111111111111111111111111111111111111111111111111111111111111111111111111111111111111111111111111111111111111111111111111111111111111111111111111111111111111111111111111111111111111111111111111111111111111111111111111111111111111111111111111111111111111111111111111111111                    1111111111                  1111111111                    1111111111                  1111111111                    111111111111                    1111111111                  1111111111                    1111111111                  1111111111                    111111111111                    1111111111                  1111111111                    1111111111                  1111111111                    1111111111111111111111111111111111111111111111111111111111111111111111111111111111111111111111111111111111111111111111111111111111111111111111111111111111111111111111111111111111111111111111111111111111111111111111111111111111111111111111111111111111111111111111111111111111111111111111111111111111111111111111111111111111111111111111111111111111111111111111111111111111111111111111111111111111111111111111111111111111111111111111111111111111111111111111111111111111111111111111111111111111111111111111111111111111111111111111111111111111111111111111111111111111111111111111111111111111111111111111111111111111111111111111111111111111111111111111111111111111111111111111111111111111111
100000000000000000000000000000000000000001                                   101  
100000000000000000000000000000000000000001                                   101  
100000000000000000000000000000000000000001                                   101  
100000000000000000000000000000000000000001                                   101  
100000000000000000000000000000000000000001                                   101  
100000000000000000000000000000000000000001                                   101  
100000000000000000000000000000000000000001                                   101  
100000000000000000000000000000000000000001                                   101  
100000000000000000000000000000000000000001                                   101  
100000000000000000000000000000000000000001                                   101  
100000000000000000000000000000000000000001                                   101  
100000000000000000000000000000000000000001                                   101  
100000000000000000000000000000000000000001                                   101                                                                              
100000000000000000000000000000000000000001                                   101  
100000000000000000000000000000000000000001                                   101111111111111111111111111111111111111111111111111111111111111111111111111111111111111111111111111111111111111111111111111111111111111111111111111111111111111111111111111111111111111111111111111111111111111111111111111111111111111111111111111111111111111111111111111111111111111111111111111111111111111111111111111111111111111111111111111111111111111111111111111111111111111111111111111111111111111111111111111111111111111111111111111111111111111111111111111111111111111111111111111111111111111111111111111111111111111111111111111111111111111111111111111111111111111111111111111111111111111111111111111111111111111111111111111111111111111111111111111111111111111111111111111111111111111111111111111111111111111111111111111111111111111111111111111111111111111111111111111111111111111111111111111111111111111111111111111111111111111111111111111111111111111111111111111111111111111111111111111111111111111111111111111111111111111111111111111111111111111111111111111111111111111111111111111111111111111111111111111111111111111111111111111111111111111111111111111111111111111111111111111111111111111111111111111111111111111111111111111111111111111111111111111111111111111111111111111111111111111111111111111111111111111111111111111111111111111111111111111111111111111111111111111111111111111111111111111111111111111111111111111111111111111111111111111111111111111111111111111111111111111111111111111111111111111111111111111111111111111111111111111111111111111111111111111111111111111111
100000000000000000000000000000000000000001                                   1000000000000000000000000000000000000000000000000000000000000000000000000000000000000000000000000000000000000000000000000000000000000000000000000000000000000000000000000000000000000000000000000000000000000000000000000000000000000000000000000000000000000000000000000000000000000000000000000000000000000000000000000000000000000000000000000000000000000000000000000000000000000000000000000000000000000000000000000000000000000000000000000000000000000000000000000000000000000000000000000000000000000000000000000000000000000000000000000000000000000000000000000000000000000000000000000000000000000000000000000000000000000000000000000000000000000000000000000000000000000000000000000000000000000000000000000000000000000000000000000000000000000000000000000000000000000000000000000000000000000000000000000000000000000000000000000000000000000000000000000000000000000000000000000000000000000000000000000000000000000000000000000000000000000000000000000000000000000000000000000000000000000000000000000000000000000000000000000000000000000000000000000000000000000000000000000000000000000000000000000000000000000000000000000000000000000000000000000000000000000000000000000000000000000000000000000000000000000000000000000000000000000000000000000000000000000000000000000000000000000000000000000000000000000000000000000000000000000000000000000000000000000000000000000000000000000000000000000000000000000000000000000000000000000000000000000000000000000000000000000000000000000000000000000000000000000000G1
100000000000000000000000000000000000000001                                   111111111111111111111111111111111111111111111111111111111111111111111111111111111111111111111111111111111111111111111111111111111111111111111111111111111111111111111111111111111111111111111111111111111111111111111111111111111111111111111111111111111111111111111111111111111111111111111111111111111111111111111111111111111111111111111111111111111111111111111111111111111111111111111111111111111111111111111111111111111111111111111111111111111111111111111111111111111111111111111111111111111111111111111111111111111111111111111111111111111111111111111111111111111111111111111111111111111111111111111111111111111111111111111111111111111111111111111111111111111111111111111111111111111111111111111111111111111111111111111111111111111111111111111111111111111111111111111111111111111111111111111111111111111111111111111111111111111111111111111111111111111111111111111111111111111111111111111111111111111111111111111111111111111111111111111111111111111111111111111111111111111111111111111111111111111111111111111111111111111111111111111111111111111111111111111111111111111111111111111111111111111111111111111111111111111111111111111111111111111111111111111111111111111111111111111111111111111111111111111111111111111111111111111111111111111111111111111111111111111111111111111111111111111111111111111111111111111111111111111111111111111111111111111111111111111111111111111111111111111111111111111111111111111111111111111111111111111111111111111111111111111111111111111111111111111111111111  
111111111111111111111111111111111111111111                                                                               
    