SO                                             ./asset/racing_south.xpm
WE                                        ./asset/Water_11.xpm
EA ./asset/racing_wall.xpm
NO 			./asset/racing_north.xpm

C +134,0000000159,247       

F 50,50,50

1111111111111111111111111111111111111111111111111111111111111111111111111111111111111111111111111111111111111111111111111111111111111111111111111111111111111111111111111111111111111111111111111111111111111111111111111111111111111111111111111111111111111111111111111111111111111111111111111111111111111111                      11111111                     1111111                      11111111                     111111                       11111111            1111111111111111111111111111111111111111111111111111111111111111111111111111111111111111111111111111111111111111111111111111111111111111111111111111111111111111111111111111111111111111111111111111111111111111111111111111111111111111111111111       
100000000000000000000000000000000000000001B00000000000000001000000001000000001000000001000000001000000001000000001000100000000000000000000000000000010000000000000000000000000000000000001000000000000000000000000000000000000000001000000000000000000000000000000000000000000000000000010000000111111111100001111                  111100001111                 11100001111                  111100001111                 11100001111                  111100001111          1000000000000000000000000000000000000000000000010000000000000000000000100000000000000000000001000101010101010101010101010101010101010101010101010101010101010101010101010101010101010101010101010101010101010101010101010101010101010101010100001111111111111111111111111111       
10000000000000000000000000000000000000000100000000000000000100000000001100000000000000000010000000000010000000000000010000000000000000000000000000001000000000000000000000000000000000000100000000000000000000000000000000000000000100000000000000000000000000000000000000000000000010000000000011111111000000001111              1111000000001111             111000000001111              1111000000001111             111000000001111              1111000000001111        100000000000000000000000100000000000110000000000000000001000000000001000000000000000000000010000010101010101010101010101010101010101010101010101010101010101010101010101010101010101010101010101010101010101010101010101010101010101010101010000000000G000000000000000000011       
1000000000000000000000000000000000000000010000010000000000000100000000000000100100000000000001000000000000001000000001000000000000001000000000000000100000000000000000100000000000000000010000000000000000001000000000000000000000010000000000000000000010000000100000000100000000000001010000001111110000001100001111          11110000111100001111         1110000001100001111          11110000111100001111         1110000001100001111          11110000111100001111      100000000000010000000000000100000000000000100100000000000001000000000000001000001000000000000010010101010101010101010101010101010101010101010101010101010101010101010101010000000000000000000000000000000000000000000000000000000000000000000000000000G000000000000000000011
1000E000000000000000000000000000000000000D0I0000000000000000000000000000000000000000000000000000000000000000000000000100000000000000100000000000000010000000000000000010000000000000000001000000000000000000100000000000000000000001000000000000000000001000000000000000000000000000000000000000111100000011111100001111      111100001111111100001111     11100000011111100001111      111100001111111100001111     11100000011111100001111      111100001111111100001111    1000000000000000000000010000000000000000000000000000000000000000000010000000000000000000000000000000000000000000000000000000000000000000000000000000000000000000000000000001010101010101010101010101010101010101010101010101010101010101010100001111111111111111111111111111
100000000000000000000000000000000000000001000000000000000000010000000000000000000000000000000100000000000000000000000100000000000000100000000000000010000000000000000010000000000000000001000000000000000000100000000000000000000001000000000000000000001000000000000000000000000000000100000000111000001111  111100001111  111100001111    111100001111  111000001111  111100001111  111100001111    111100001111  111000001111  111100001111  111100001111    111100001111  1000000000000000000000000001000000000000000000000000000000010000000000000000000000000000000000100101010101010101010101010101010101010101010101010101010101010101010101010101010101010101010101010101010101010101010101010101010101010101010100001
1000000000000000000000000000000000000000010000000000001000001000000000000000100000000010000010000000000000001000000000000000000000001000000000000000000000000000000000100000000000000000000000000000000000001000000000000000000000000000000000000000000010000000000000010000000010000010000000001000001111      1111000011111100001111        1111000011111000001111      1111000011111100001111        1111000011111000001111      1111000011111100001111        1111000011111000000000000000000010000010000000000000001000000000100000100000000000000010000000000001000001000101010101010101010101010101010101010101010101010101010101010101010101010101010101010101010101010101010101010101010101010101010101010101010100001
10000000000000000000000000000000000000000100000010000000000000000001000000000000100000000000000000010000000010000000000000000000000010000000000000000000000000000000001000000000000000000000000000000000000010000000000000000000000000000000000000000000100000000100000000100000000000000010000000001111          111100000000001111            111100000000001111          111100000000001111            111100000000001111          111100000000001111            11110000000000000000000010000000000000000001000000001000100000000000000000010000000010000001000000000000000101010101010101010101010101010101010101010101010101010101010101010101010101010101010101010101010101010101010101010101010101010101010101010101001       
100000000000000000000000000000000000000001000000000000100001000000000000000001000000001000000001000000001000000001000000000000000000100000000000000000000000000000000010000000000000000000000000000000000000100000000000000000000000000000000000000000001000000000000001000000001000000000000000000111              11110000001111                11110000000111              11110000001111                11110000000111              11110000001111                111100000000000000000000000010000000000000000000000000000000100000000000000000000000000000000001000000000101010101010101010101010101010101010101010101010101010101010101010101010101010101010101010101010101010101010101010101010101010101010101010100001       
1001000001000000001000000100000000000000011111111111111111111111111111111111111111111111111111111111111111111111111111111111111111111111111111111111111111111111111111111111111111111111111111111111111111111111111111111111111111111111111111111111111111111111111111111111111111111111111111111111                  1111111111                    1111111111                  1111111111                    1111111111                  1111111111                    1111111111111111111111111111111111111111111111111111111111111111111111111111111111111111111111111111111111111111111111111111111111111111111111111111111111111111111111111111111111111111111111111111111111111111111111111111111111111111111111111111111       
100100000100000000100000010000000000000001                                     
100100000100000000100000010000000010000001                                     
100100000100000000100000010000000010000001                                     
100100000100000000100000010000000010000001                                     
1001000001D1D1D1D1100000010000000010000001                                     
1001111D1100000000100000010000000010000001                                     
100100000100000000100000010000000010000001                                     
100100000100000000100000010000000010000001                                     
11D100000100000000100000010000000010000001                                     
100100000100000000100000010000000010000001                                     
100100000100000000100000010000000010000001                                     
100100000100000000100000010000000010000001                                     
100100000100000000100000010000000010000001                                                                                                                 
100100000100000000100000010000000010000001                                     
100100000100000000100000010000000010000001                                   
100000000000000000000000000000000000000001                                   
100000000000000000000000000000000000000001                                   
111111111111111111111111111111111111111111                                                                               
    