SO                                             ./asset/Water_1.xpm
WE                                        ./asset/Water_11.xpm
EA ./asset/Water_10.xpm
NO 			./asset/Water_12.xpm

C +134,0000000159,247       

F 24,100,171

1111111111111111111111111111111111111111111111111111111111111111111111111111111111111111111111111111111111111111111111111111111111111111111111111111111111111111111111111111111111111111111111111111111111111111111111111111111111111111111111111111111111111111111111           111            111            111            111      11111111111111111111111111111111111111111111111111111111111111111111111111111111111111111111111111111111111111111111111111111111111111111111111111111111111111111111111111111111111111111111111111111111111111111111111111111111111111111111111111111111111111111111111111111111111111111111111111111111111111111111111111           111            111            111            111      1111111111           111            111            111            111      1111111111           111            111            111            111      11111111111111111111111111111111111111111111111111111111111111111111111111111111111111111111111111111111111111111111111111111111111111111111111111111111111111111111111111111111111111111111111111111111111111111111111111111111111111111111111111111111111111111111111111111111111111111111111111111111111111111111111111111111111111111111111111111111111111111111111111111111111111111111111111111111111111111111111111111111111111111111111111111111111111111111111111111111111111111111111111111111111111111111111111111111111111
10000000000000000000000000000000000000000100000000000000000100000000100000000100000000100000000100000000100000000100010000000000100000000001000000000010000000000000000000000000000000000000000000000000000000000000000000000000000000000000000000000000000001111110011         11011          11011          11011          11011     100000000000000000000000000000000000000000000000000000000000000000000000000000000000000000000000000000000000011000000000000000000000000001100000000000000000000000000110000000000000000000000000000000000000000000000000000001100000000000000000000000000110000000000000000000000000011000000000000000000000000001111110011         11011          11011          11011          11011     11111110011         11011          11011          11011          11011     11111110011         11011          11011          11011          11011     10000000000000000000000000000000000000000000000000000000000000000000000000000000000000000000000000000000000000000000000000000000000000000000000000000000100000000000000000000001000000000000000000000010000000000000000000000100000000000000000000001000000000000000000000010000000000000000000000100000000000000000000001000000000000000000000000000000000000000000000000000000000000000000000000000000000000100000000000000000001000000000000000000010000000000000000000100000000000000000001000000000000000000010000000000000000001
100000000000000000000000000000000000000001000000000000000010000000000011000000000000000000100000000000110000000000000100000000001000000000010000000000100000000000000000000000000000000000000000000000000000000000000000000000000000000000000000000000000000011111000011       1100011        1100011        1100011        1100011    1000000000000000000000000000000000000000000000000000000000000000000000000000000000000000000000000000000000000110000000000000000000000000011000000000000000000000000001100000000000000000000000000110000000000000000000000000011000000000000000000000000001100000000000000000000000000110000000000000000000000000011111000011       1100011        1100011        1100011        1100011    111111000011       1100011        1100011        1100011        1100011    111111000011       1100011        1100011        1100011        1100011    10000000000000000000000000000000000000000000000000000000000000000000000000000000000000000000000000000000000000000000000000000000010000000000011000000000000000000100000000000110000000000000000000001000000000001100000000000000000010000000000011000000000000000000000100000000000110000000000000000001000000000001100000000000000000000010000000000011000000000000000000100000000000110000000000000000000001000000000001100000000000000000010000000000011000000000000000000000100000000000110000000000000000001000000000001100000001
1000000000000000000000000000000000000000010000010000000000000100000000000000100100000000000001000000000000001000000001000001000010000010000100000100001000001000000000000000000000000000000000000000000000000000000000000000000000000000000000000000000000000111100010011     110010011      110010011      110010011      110010011   10000000000000000000000000000000000000000000000000000000000000000000000000000000000000000000000000000000000000000000000000000000000000000110000000000000000000000000011000000000000000000000000001100000000000000000000000000000000000000000000000000000011000000000000000000000000001100000000000000000000000000111100010011     110010011      110010011      110010011      110010011   1111100010011     110010011      110010011      110010011      110010011   1111100010011     110010011      110010011      110010011      110010011   100000000000000000000000000000000000000000000000000000000000000000000000000000000000000000000000000000000000000000000010000000000000100000000000000100100000000000001000000000000001000001000000000000010000000000000010010000000000000100000000000000100000100000000000001000000000000001001000000000000010000000000000010000010000000000000100000000000000100100000000000001000000000000001000001000000000000010000000000000010010000000000000100000000000000100000100000000000001000000000000001001000000000000010000000000000010011111111
10000000000000000000000000000000000000000200000000000000000000000000000000000000000000000000000000000000000000000000010000010000100000100001000001000010000010000000000000000000000000000000000000000000000000000000000000000000000000000000000000000000000001110001110011   11001110011    11001110011    11001110011    11001110011  100000000000000000000000000000000000000000000000000000000000000000000000000000000000000000000000000000000000011000000000000000000000000001100000000000000000000000000000000000000000000000000000011000000000000000000000000001100000000000000000000000000110000000000000000000000000000000000000000000000000000001110001110011   11001110011    11001110011    11001110011    11001110011  11110001110011   11001110011    11001110011    11001110011    11001110011  11110001110011   11001110011    11001110011    11001110011    11001110011  1000000000000000000000000000000000000000000000000000000000000000000000000000000000000000000000000000000000000000000000000000000000000000000000000000000000000000000000000000000000000000000000000000000000000000000000000000000000000000000000000000000000000000000000000000000000000000000000000000000000000000000000000000000000000000000000000000000000000000000000000000000000000000000000000000000000000000000000000000000000000000000000000000000000000000000000000000000000000000000000000000000000000000000000000000000000000000000G1
10000000000000000000000000000000000000000100000000000000000001000000000000000000000000000000010000000000000000000000010000010000100000100001000001000010000010000000000000000000000000000000000000000000000000000000000000000000000000000000000000000000000001100011 110011 110011 110011  110011 110011  110011 110011  110011 110011 100000000000000000000000000000000000000000000000000000000000000000000000000000000000000000000000000000000000011000000000000000000000000001100000000000000000000000000110000000000000000000000000011000000000000000000000000001100000000000000000000000000110000000000000000000000000011000000000000000000000000001100011 110011 110011 110011  110011 110011  110011 110011  110011 110011 11100011 110011 110011 110011  110011 110011  110011 110011  110011 110011 11100011 110011 110011 110011  110011 110011  110011 110011  110011 110011 1000000000000000000000000000000000000000000000000000000000000000000000000000000000000000000000000000000000000000000000000000000000001000000000000000000000000000000010000000000000000000000000000000000100000000000000000000000000000001000000000000000000000000000000000010000000000000000000000000000000100000000000000000000000000000000001000000000000000000000000000000010000000000000000000000000000000000100000000000000000000000000000001000000000000000000000000000000000010000000000000000000000000000000100000000000000000000000G1
1000000000000000000000000000000000000000010000000000001000001000000000000000100000000010000010000000000000001000000000000001000000000010000000000100000000001000000000000000000000000000000000000000000000000000000000000000000000000000000000000000000000000100011   11001110011   110011110011   110011110011   110011110011   11001110000000000000000000000000000000000000000000000000000000000000000000000000000000000000000000000000000000000001100000000000000000000000000110000000000000000000000000011000000000000000000000000001100000000000000000000000000110000000000000000000000000011000000000000000000000000001100000000000000000000000000100011   11001110011   110011110011   110011110011   110011110011   1100111100011   11001110011   110011110011   110011110011   110011110011   1100111100011   11001110011   110011110011   110011110011   110011110011   110011100000000000000000000000000000000000000000000000000000000000000000000000000000000000000000000000000000000000000000000000000001000001000000000000000100000000010000010000000000000001000000000000100000100000000000000010000000001000001000000000000000100000000000010000010000000000000001000000000100000100000000000000010000000000001000001000000000000000100000000010000010000000000000001000000000000100000100000000000000010000000001000001000000000000000100000000000010000010000000000000001000000000100000100000000000000010011111111
1000W0000000000000000000000000000000000001000000100000000000000000010000000010001000000000000000000100000000100000000000000100000000001000000000010000000000100000000000000000000000000000000000000000000000000000000000000000000000000000000000000000000000000011     110000011     1100000011     1100000011     1100000011     110000000000000000000000000000000000000000000000000000000000000000000000000000000000000000000000000000000000000000110000000000000000000000000000000000000000000000000000001100000000000000000000000000110000000000000000000000000011000000000000000000000000000000000000000000000000000000110000000000000000000000000000011     110000011     1100000011     1100000011     1100000011     11000000011     110000011     1100000011     1100000011     1100000011     11000000011     110000011     1100000011     1100000011     1100000011     1100000000000000000000000000000000000000000000000000000000000000000000000000000000000000000000000000000000000000000000000000100000000000000000010000000010001000000000000000000100000000100000010000000000000000001000000001000100000000000000000010000000010000001000000000000000000100000000100010000000000000000001000000001000000100000000000000000010000000010001000000000000000000100000000100000010000000000000000001000000001000100000000000000000010000000010000001000000000000000000100000000100010000000000000000001000000001001
10000000000000000000000000000000000000000100000000000010000100000000100000000100000000100000000100000000100000000100000000010000000000100000000001000000000010000000000000000000000000000000000000000000000000000000000000000000000000000000000000000000000000011       1100011       11000011       11000011       11000011       1100000000000000000000000000000000000000000000000000000000000000000000000000000000000000000000000000000000000000011000000000000000000000000001100000000000000000000000000110000000000000000000000000011000000000000000000000000001100000000000000000000000000110000000000000000000000000011000000000000000000000000000011       1100011       11000011       11000011       11000011       110000011       1100011       11000011       11000011       11000011       110000011       1100011       11000011       11000011       11000011       110000000000000000000000000000000000000000000000000000000000000000000000000000000000000000000000000000000000000000000000000000000100000000000000000000000000000001000000000000000000000000000000000010000000000000000000000000000000100000000000000000000000000000000001000000000000000000000000000000010000000000000000000000000000000000100000000000000000000000000000001000000000000000000000000000000000010000000000000000000000000000000100000000000000000000000000000000001000000000000000000000000000000010000000000000000000000001
1000000000000000000000000000000000000000011111111111111111111111111111111111112111111111111111111111111111111111111111111111111111111111111111111111111111111111111111111111111111111111111111111111111111111111111111111111111111111111111111111111111111111111         11111         111111         111111         111111         11111111111111111111111111111111111111111111111111111111111111111111111111111111111111111111111111111111111111111111111111111111111111111111111111111111111111111111111111111111111111111111111111111111111111111111111111111111111111111111111111111111111111111111111111111111111111111111111111111111111111111111111         11111         111111         111111         111111         1111111         11111         111111         111111         111111         1111111         11111         111111         111111         111111         11111111111111111111111111111111111111111111111111111111111111111111111111111111111111111111111111111111111111111111111111111111111111111111111111111111111111111111111111111111111111111111111111111111111111111111111111111111111111111111111111111111111111111111111111111111111111111111111111111111111111111111111111111111111111111111111111111111111111111111111111111111111111111111111111111111111111111111111111111111111111111111111111111111111111111111111111111111111111111111111111111111111111111111111111111111111111111
100000000000000000000000000000000000000001                                   101  
100000000000000000000000000000000000000001                                   101  
100000000000000000000000000000000000000001                                   101  
100000000000000000000000000000000000000001                                   101  
100000000000000000000000000000000000000001                                   101  
100000000000000000000000000000000000000001                                   101  
100000000000000000000000000000000000000001                                   101  
100000000000000000000000000000000000000001                                   101  
100000000000000000000000000000000000000001                                   101  
100000000000000000000000000000000000000001                                   101  
100000000000000000000000000000000000000001                                   101  
100000000000000000000000000000000000000001                                   101  
100000000000000000000000000000000000000001                                   101                                                                              
100000000000000000000000000000000000000001                                   101  
100000000000000000000000000000000000000001                                   10111111111111111111111111111111111111111111111111111111111111111111111111111111111111111111111111111111111111111111111111111111111111111111111111111111111111111111111111111111111111111111111111111111111111111111111111111111111111111111111111111111111111111111111111111111111111111111111111111111111111111111111111111111111111111111111111111111111111111111111111111111111111111111111111111111111111111111111111111111111111111111111111111111111111111111111111111111111111111111111111111111111111111111111111111111111111111111111111111111111111111111111111111111111111111111111111111111111111111111111111111111111111111111111111111111111111111111111111111111111111111111111111111111111111111111111111111111111111111111111111111111111111111111111111111111111111111111111111111111111111111111111111111111111111111111111111111111111111111111111111111111111111111111111111111111111111111111111111111111111111111111111111111111111111111111111111111111111111111111111111111111111111111111111111111111111111111111111111111111111111111111111111111111111111111111111111111111111111111111111111111111111111111111111111111111111111111111111111111111111111111111111111111111111111111111111111111111111111111111111111111111111111111111111111111111111111111111111111111111111111111111111111111111111111111111111111111111
100000000000000000000000000000000000000001                                   100000000000000000000000000000000000000000000000000000000000000000000000000000000000000000000000000000000000000000000000000000000000000000000000000000000000000000000000000000000000000000000000000000000000000000000000000000000000000000000000000000000000000000000000000000000000000000000000000000000000000000000000000000000000000000000000000000000000000000000000000000000000000000000000000000000000000000000000000000000000000000000000000000000000000000000000000000000000000000000000000000000000000000000000000000000000000000000000000000000000000000000000000000000000000000000000000000000000000000000000000000000000000000000000000000000000000000000000000000000000000000000000000000000000000000000000000000000000000000000000000000000000000000000000000000000000000000000000000000000000000000000000000000000000000000000000000000000000000000000000000000000000000000000000000000000000000000000000000000000000000000000000000000000000000000000000000000000000000000000000000000000000000000000000000000000000000000000000000000000000000000000000000000000000000000000000000000000000000000000000000000000000000000000000000000000000000000000000000000000000000000000000000000000000000000000000000000000000000000000000000000000000000000000000000000000000000000000000000000000000000000000000000000000000000000000000000000G1
100000000000000000000000000000000000000001                                   11111111111111111111111111111111111111111111111111111111111111111111111111111111111111111111111111111111111111111111111111111111111111111111111111111111111111111111111111111111111111111111111111111111111111111111111111111111111111111111111111111111111111111111111111111111111111111111111111111111111111111111111111111111111111111111111111111111111111111111111111111111111111111111111111111111111111111111111111111111111111111111111111111111111111111111111111111111111111111111111111111111111111111111111111111111111111111111111111111111111111111111111111111111111111111111111111111111111111111111111111111111111111111111111111111111111111111111111111111111111111111111111111111111111111111111111111111111111111111111111111111111111111111111111111111111111111111111111111111111111111111111111111111111111111111111111111111111111111111111111111111111111111111111111111111111111111111111111111111111111111111111111111111111111111111111111111111111111111111111111111111111111111111111111111111111111111111111111111111111111111111111111111111111111111111111111111111111111111111111111111111111111111111111111111111111111111111111111111111111111111111111111111111111111111111111111111111111111111111111111111111111111111111111111111111111111111111111111111111111111111111111111111111111111111111111111111111111  
111111111111111111111111111111111111111111                                                                               
    