SO                                             ./asset/Water_1.xpm
WE                                        ./asset/Water_6.xpm
EA ./asset/Water_11.xpm
NO ./asset/Water_10.xpm
C +134,0000000159,247
F 24,100,171

111111111111
100000000001
100000000001
100000000001
10000N000001
100010100001
100000000001
100000000001
111111111111

1
