SO                                             ./path_to_the_south_texture
WE                                        ./path_to_the_west_texture
EA ./path_to_the_east_texture
NO ./path_to_the_north_texture
C +225,000000030,+1
F 220,100,14

111111111111
100000000001
100000000001
100000000001
10000N000001
100010100001
100000000001
100000000001
111111111111
